##########################################################
]      %     ######     %   %      #######   %    A     ##
#    ### %%   #    #     ### ##### #  B  #  %% #######  ##
# %  #     %  # %  # %       # %   # %   #    % #     #  #
### ###### #### ## ####### ### ### # ### ##### ## %%% #  #
#   #         #    %   %     %     #     %     #   #  #  #
#   #~~~~~    ###### ########### ####### ####### ### #####
# % #~~~~~    #        %      %   %   %   %         #    #
# # ####### # #  ####### ########### ########### %###  % #
# #       # # %  #  B  %    %     %       %   #     #    #
# ######### ###### ######### ### ######### ### ####### ###
#    B %        %    %    %     # %     #     #       %  /
##### ######### ####### ####### # ### ### ### ### ######%#
#     %     A   %     # %  B  # #   %     %   #   %   %  #
# ####### ####### ### # ####### ##### ####### ###### % ###
# #     % #     #     #         %   #     %       %      #
# # ##### # ### ####### ########### # #######%#########  #
#     B  % #   %   B %   %     %     #     %     %       #
##########################################################
